...###.....
#..##......
#..####..##
...#..#..#.
..##..#.##.
.##........
.#....@....
#....######
.......###.
####..##.#.
#..#.##..##
