...###
..##.#.####
.##..###..#
##........#
#......#..#
###..###..#
..#..#....#
..#.##...##
........##
..@.....#
.#######